11111111111111111111111111111111
1P000000000000000000000000000001
10111111111111000001111111111101
10000000000000100001000000000001
10001111111110100001011111111001
1C001000000001000010000000010C01
11110101111111101111111110101011
10000101000000000000000010101001
10111101011111111111111010101101
10000001010000000000001010000001
10000001010111111111101010111101
10000001010000000000001010000001
10111111010111111111101010111101
10000000010000000000001010000001
10000000011111111111111011111001
1C0000000000000000000000000000C1
10111111111111111111111111111101
10000000000000000000000000000001
10011111111111111111111111111001
1C0000000000000000000000000000E1
11111111111111101111111111111111
1C0000000000000000000000000000C1
10011111111111111111111111111001
10000000000000000000000000000001
10111111111111111111111111111101
1C000000000000000000000000000001
11111111111111101111111111111111
10000000000000000000000000000001
10011111111111111111111111111001
1C0000000000000000000000000000C1
11111111111111111111111111111111
