111111111111111111111111111111
100000000000000000000000000001
100011111110000011111111100001
100010000010000010000000100001
100010C00010001000000C01000001
100011111110001111111110011101
100000000000000000000000000001
101111100111111001111100111101
100000100100001001000100100001
100C001000C0001000001000000C01
111111111111111111111111111101
100000000000000000000000000001
100011111111111111111111100001
100010000000000000000000100001
100010C001111111100C0001000001
100011111100000001111111111101
100000000000000000000000000001
101111111111111111111111111101
100000000000000C00000000000001
100C0000000000000000000C000001
100000111111111111111111100001
100000000000000000000000000001
1P00000000000000000000000000E1
111111111111111111111111111111
