111111111111111111111111111111
1000000000000C0000000000000001
100111111111111111111111111101
100000000000000000000000000001
100011111111111111111111111001
100001000000000000000000010001
111101011111111111111111101111
100001010000C00000000000101001
101111010111111111111111101101
100000010100000000000000100001
100000010101111111111111101101
100000010100000000000000100001
101111110101111111111111101101
100000000100000000000000100001
100000000111111111111111110001
100000000000000000000000000001
10000000000C000000000000000001
101111111111111111111111111101
100000000000000000000000000001
1P00000000000000000000000E0001
111111111111111111111111111111
